###############
#     @       #
#             #
#      *      #
#   B         #
#             #
###############